  0   0   0
 72   0   0
100   0   0
128   0   0
156   0   0
180   0   0
208   0   0
236   0   0
240   0   0
216   0   0
192   0   0
168   0   0
144   0   0
120   0   0
 96   0   0
 72   0   0
 72   0   0
 96   0   0
120   0   0
144   0   0
168   0   0
192   0   0
216   0   0
240   0   0
240   0   0
216   0   0
192   0   0
168   0   0
144   0   0
120   0   0
 96   0   0
 72   0   0
 72   0   0
 96   0   0
120   0   0
144   0   0
168   0   0
192   0   0
216   0   0
240   0   0
240   0   0
216   0   0
192   0   0
168   0   0
144   0   0
120   0   0
 96   0   0
 72   0   0
 72   0   0
 96   0   0
120   0   0
144   0   0
168   0   0
192   0   0
216   0   0
240   0   0
240   0   0
216   0   0
192   0   0
168   0   0
144   0   0
120   0   0
 96   0   0
 72   0   0
 72   0   0
 96   0   0
120   0   0
144   0   0
168   0   0
192   0   0
216   0   0
240   0   0
240   0   0
216   0   0
192   0   0
168   0   0
144   0   0
120   0   0
 96   0   0
 72   0   0
 72   0   0
 96   0   0
120   0   0
144   0   0
168   0   0
192   0   0
216   0   0
240   0   0
240   0   0
216   0   0
192   0   0
168   0   0
144   0   0
120   0   0
 96   0   0
 72   0   0
 72   0   0
 96   0   0
120   0   0
144   0   0
168   0   0
192   0   0
216   0   0
240   0   0
240   0   0
216   0   0
192   0   0
168   0   0
144   0   0
120   0   0
 96   0   0
 72   0   0
 72   0   0
 96   0   0
120   0   0
144   0   0
168   0   0
192   0   0
216   0   0
240   0   0
236   0   0
204   0   0
172   0   0
140   0   0
108   0   0
 76   0   0
  0   0   0
  4   4   4
  4   4   4
